6 8
### #
# # ##
# # #
# ## #
# #
# ####
# #
#### #